111111111111111111111111111111111111111
1000000000000000000000CCC0E000000000001
111111000011111111111100011111111111111
1111110000111111111111P0011111111111111
111111000011111111111100011111111111111
111111111111111111111111111111111111111