11111111111111
10000000011111
1CC1111PE11111
10000000000001
11111111111111
